2,0,0,0,0,0,0,0,0,0,0,0,0,0,2,0,9,9,0,0,0,0,0,0,2
2,0,0,0,0,0,0,0,0,0,0,0,0,0,2,0,0,0,0,0,0,0,0,0,2
2,0,0,0,7,0,0,0,0,0,0,0,0,0,2,0,0,0,0,3,0,0,0,0,2
2,0,0,0,0,0,0,9,9,0,0,0,0,9,0,0,0,0,0,0,0,0,0,0,2
2,0,0,3,0,0,0,0,0,0,0,0,0,8,0,0,0,0,0,0,0,3,0,0,2
2,0,0,0,0,0,0,0,0,0,5,0,5,0,1,1,0,0,0,0,0,0,0,0,2
2,0,0,0,3,0,0,0,0,0,0,0,0,0,0,0,0,0,5,0,3,0,0,0,2
2,0,0,0,0,0,0,0,0,0,9,0,0,0,0,0,0,0,7,0,0,0,0,0,2
2,0,0,0,0,3,0,0,0,9,8,9,0,0,0,8,8,0,0,0,0,0,0,0,2
2,0,0,0,0,0,0,0,9,0,8,0,9,0,0,0,9,0,0,0,0,0,8,0,2
2,0,0,0,0,0,3,5,5,8,8,8,3,1,1,4,4,4,1,1,0,0,8,0,2
2,0,0,0,0,0,0,0,0,0,0,0,0,0,0,0,0,0,0,0,1,1,1,0,2
2,0,0,0,0,0,0,0,0,0,0,0,0,0,0,0,0,0,0,0,0,0,0,9,2
2,8,8,8,8,8,8,8,8,8,8,8,8,8,8,8,8,8,8,8,8,8,8,8,2
2,2,2,2,2,2,2,2,2,2,2,2,2,2,2,2,2,2,2,2,2,2,2,2,2
21,9
